{
	"map_size": [12, 12],
	"map_grid":
	[
		[2, 2, 2, 2, 2, 2, 2, 2, 2, 2, 3, 3],
		[2, 2, 1, 1, 2, 2, 2, 2, 1, 1, 3, 3],
		[2, 2, 1, 1, 1, 2, 1, 1, 1, 1, 3, 3],
		[2, 1, 1, 1, 2, 2, 1, 1, 1, 1, 1, 3],
		[2, 1, 1, 1, 2, 1, 1, 1, 1, 1, 1, 3],
		[2, 1, 1, 1, 1, 1, 1, 1, 1, 1, 3, 3],
		[2, 2, 1, 1, 1, 1, 1, 1, 1, 3, 3, 3],
		[2, 2, 1, 1, 1, 1, 1, 1, 1, 3, 3, 3],
		[2, 2, 1, 1, 1, 2, 1, 1, 3, 3, 3, 3],
		[2, 1, 1, 1, 2, 2, 1, 1, 3, 3, 3, 3],
		[2, 1, 1, 2, 2, 2, 3, 3, 3, 3, 3, 3],
		[2, 2, 2, 2, 2, 3, 3, 3, 3, 3, 3, 3]
	],
	"start_point": [6, 6],
	"events":
	[
		{
			"x": 8,
			"y": 7,
			"file": "fishermen.json"
		}
	]
}